aspire is a word found in the books: ['frankenstein', 'pride', 'scarletletter', 'jane']
composure is a word found in the books: ['frankenstein', 'pride', 'jekyllhyde', 'littlewomen', 'scarletletter', 'crimepunish', 'jane', 'taleoftwocities']
abstract is a word found in the books: ['mobydick', 'crimepunish', 'dracula', 'jane']
assert is a word found in the books: ['mobydick', 'pride', 'littlewomen', 'scarletletter', 'crimepunish', 'dracula', 'jane', 'taleoftwocities']
deplore is a word found in the books: ['mobydick', 'littlewomen', 'taleoftwocities']
accessible is a word found in the books: ['mobydick', 'dracula', 'jane', 'taleoftwocities']
assumption is a word found in the books: ['mobydick', 'crimepunish', 'dracula', 'taleoftwocities']
authentic is a word found in the books: ['mobydick', 'scarletletter', 'crimepunish', 'dracula']
confirm is a word found in the books: ['frankenstein', 'pride', 'littlewomen', 'scarletletter', 'crimepunish', 'jane', 'taleoftwocities']
acknowledge is a word found in the books: ['pride', 'littlewomen', 'scarletletter', 'crimepunish', 'dracula', 'jane', 'taleoftwocities']
aversion is a word found in the books: ['frankenstein', 'littlewomen', 'crimepunish', 'jane', 'taleoftwocities']
derision is a word found in the books: ['mobydick', 'pride', 'alice']
congenial is a word found in the books: ['frankenstein', 'mobydick', 'pride', 'scarletletter', 'jane', 'taleoftwocities']
conscientious is a word found in the books: ['mobydick', 'pride', 'littlewomen', 'crimepunish', 'jane']
beneficial is a word found in the books: ['frankenstein', 'pride', 'littlewomen', 'crimepunish', 'dracula', 'jane', 'taleoftwocities']
detached is a word found in the books: ['mobydick', 'pride', 'taleoftwocities']
adverse is a word found in the books: ['mobydick', 'scarletletter', 'jane']
benign is a word found in the books: ['scarletletter', 'dracula', 'jane']
consistency is a word found in the books: ['mobydick', 'pride', 'jane']
betray is a word found in the books: ['frankenstein', 'pride', 'littlewomen', 'scarletletter', 'crimepunish', 'dracula', 'jane', 'taleoftwocities']
affable is a word found in the books: ['pride', 'littlewomen', 'crimepunish', 'jane']
brittle is a word found in the books: ['mobydick', 'pride', 'jane']
diffident is a word found in the books: ['frankenstein', 'pride', 'littlewomen', 'crimepunish', 'jane']
alleviate is a word found in the books: ['frankenstein', 'pride', 'jane']
discernible is a word found in the books: ['mobydick', 'pride', 'taleoftwocities']
ambiguous is a word found in the books: ['mobydick', 'littlewomen', 'crimepunish']
disclose is a word found in the books: ['frankenstein', 'pride', 'scarletletter', 'dracula', 'jane', 'taleoftwocities']
discord is a word found in the books: ['crimepunish', 'dracula', 'jane']
amenable is a word found in the books: ['scarletletter', 'dracula', 'jane']
ample is a word found in the books: ['frankenstein', 'mobydick', 'pride', 'jane', 'taleoftwocities']
apathy is a word found in the books: ['frankenstein', 'littlewomen', 'crimepunish', 'dracula', 'jane']
decorous is a word found in the books: ['littlewomen', 'scarletletter', 'crimepunish']
disinterested is a word found in the books: ['frankenstein', 'mobydick', 'pride', 'jane']
dismiss is a word found in the books: ['littlewomen', 'crimepunish', 'dracula', 'jane', 'taleoftwocities']
apprehension is a word found in the books: ['frankenstein', 'mobydick', 'pride', 'jekyllhyde', 'scarletletter', 'crimepunish', 'dracula', 'jane', 'taleoftwocities']
deference is a word found in the books: ['frankenstein', 'pride', 'littlewomen', 'crimepunish', 'dracula', 'jane', 'taleoftwocities']
appropriate is a word found in the books: ['mobydick', 'littlewomen', 'scarletletter', 'crimepunish', 'jane', 'taleoftwocities']
compliance is a word found in the books: ['mobydick', 'pride', 'scarletletter', 'dracula', 'jane', 'taleoftwocities']
defiance is a word found in the books: ['frankenstein', 'mobydick', 'pride', 'jekyllhyde', 'littlewomen', 'scarletletter', 'crimepunish', 'jane', 'taleoftwocities']
degenerate is a word found in the books: ['pride', 'littlewomen', 'scarletletter', 'jane', 'taleoftwocities']
reprehensible is a word found in the books: ['mobydick', 'pride', 'littlewomen', 'dracula']
hostility is a word found in the books: ['mobydick', 'scarletletter', 'crimepunish', 'dracula', 'jane']
disperse is a word found in the books: ['jekyllhyde', 'littlewomen', 'jane']
nocturnal is a word found in the books: ['frankenstein', 'jekyllhyde', 'dracula']
reserved is a word found in the books: ['frankenstein', 'mobydick', 'pride', 'littlewomen', 'scarletletter', 'crimepunish', 'dracula', 'jane', 'taleoftwocities']
resignation is a word found in the books: ['frankenstein', 'pride', 'littlewomen', 'scarletletter', 'dracula', 'jane', 'taleoftwocities']
resolution is a word found in the books: ['frankenstein', 'mobydick', 'pride', 'jekyllhyde', 'littlewomen', 'crimepunish', 'dracula', 'jane', 'taleoftwocities']
distinction is a word found in the books: ['frankenstein', 'mobydick', 'pride', 'littlewomen', 'scarletletter', 'dracula', 'jane', 'taleoftwocities']
notorious is a word found in the books: ['mobydick', 'crimepunish', 'taleoftwocities']
immutable is a word found in the books: ['frankenstein', 'mobydick', 'jane']
docile is a word found in the books: ['frankenstein', 'mobydick', 'littlewomen', 'jane', 'taleoftwocities']
obnoxious is a word found in the books: ['frankenstein', 'jekyllhyde', 'jane', 'taleoftwocities']
resolve is a word found in the books: ['frankenstein', 'mobydick', 'pride', 'jekyllhyde', 'littlewomen', 'scarletletter', 'dracula', 'jane', 'taleoftwocities']
doctrine is a word found in the books: ['mobydick', 'crimepunish', 'dracula', 'jane', 'taleoftwocities']
restraint is a word found in the books: ['mobydick', 'pride', 'jekyllhyde', 'littlewomen', 'scarletletter', 'crimepunish', 'dracula', 'jane', 'taleoftwocities']
imperceptible is a word found in the books: ['frankenstein', 'mobydick', 'scarletletter', 'dracula']
implacable is a word found in the books: ['pride', 'dracula', 'jane', 'taleoftwocities']
obscure is a word found in the books: ['frankenstein', 'mobydick', 'jekyllhyde', 'littlewomen', 'scarletletter', 'crimepunish', 'dracula', 'jane', 'taleoftwocities']
opaque is a word found in the books: ['frankenstein', 'scarletletter', 'jane']
retain is a word found in the books: ['frankenstein', 'mobydick', 'pride', 'scarletletter', 'crimepunish', 'dracula', 'jane', 'taleoftwocities']
eclipse is a word found in the books: ['littlewomen', 'crimepunish', 'jane']
orator is a word found in the books: ['mobydick', 'crimepunish', 'jane', 'taleoftwocities']
elated is a word found in the books: ['mobydick', 'pride', 'littlewomen']
impromptu is a word found in the books: ['littlewomen', 'crimepunish', 'jane']
ostentatious is a word found in the books: ['mobydick', 'pride', 'taleoftwocities']
ruthless is a word found in the books: ['mobydick', 'dracula', 'jane', 'taleoftwocities']
incongruity is a word found in the books: ['mobydick', 'scarletletter', 'crimepunish']
pacify is a word found in the books: ['jekyllhyde', 'littlewomen', 'scarletletter', 'dracula', 'jane']
seclusion is a word found in the books: ['frankenstein', 'mobydick', 'pride', 'jekyllhyde', 'littlewomen', 'scarletletter', 'jane', 'taleoftwocities']
inconsistency is a word found in the books: ['pride', 'littlewomen', 'scarletletter', 'taleoftwocities']
serenity is a word found in the books: ['frankenstein', 'mobydick', 'pride', 'littlewomen', 'scarletletter', 'crimepunish', 'jane']
severity is a word found in the books: ['frankenstein', 'pride', 'jekyllhyde', 'alice', 'scarletletter', 'crimepunish', 'jane', 'taleoftwocities']
indifferent is a word found in the books: ['frankenstein', 'mobydick', 'pride', 'jekyllhyde', 'littlewomen', 'scarletletter', 'crimepunish', 'dracula', 'jane', 'taleoftwocities']
singular is a word found in the books: ['frankenstein', 'mobydick', 'pride', 'jekyllhyde', 'scarletletter', 'crimepunish', 'jane', 'taleoftwocities']
induce is a word found in the books: ['frankenstein', 'mobydick', 'pride', 'jekyllhyde', 'crimepunish', 'dracula', 'jane', 'taleoftwocities']
perpetual is a word found in the books: ['frankenstein', 'pride', 'littlewomen', 'scarletletter', 'crimepunish', 'dracula', 'jane']
industrious is a word found in the books: ['frankenstein', 'mobydick', 'littlewomen', 'crimepunish', 'jane', 'taleoftwocities']
steadfast is a word found in the books: ['mobydick', 'pride', 'littlewomen', 'scarletletter', 'jane']
infallible is a word found in the books: ['frankenstein', 'mobydick', 'littlewomen', 'crimepunish', 'jane', 'taleoftwocities']
phenomena is a word found in the books: ['frankenstein', 'mobydick', 'jekyllhyde', 'scarletletter']
stratagem is a word found in the books: ['mobydick', 'littlewomen', 'crimepunish']
ingenious is a word found in the books: ['mobydick', 'pride', 'littlewomen', 'crimepunish', 'jane', 'taleoftwocities']
subdued is a word found in the books: ['frankenstein', 'mobydick', 'alice', 'littlewomen', 'scarletletter', 'crimepunish', 'dracula', 'jane', 'taleoftwocities']
superfluous is a word found in the books: ['frankenstein', 'mobydick', 'scarletletter', 'crimepunish', 'jane']
esteem is a word found in the books: ['frankenstein', 'mobydick', 'pride', 'jekyllhyde', 'littlewomen', 'scarletletter', 'crimepunish', 'dracula', 'jane', 'taleoftwocities']
potency is a word found in the books: ['mobydick', 'scarletletter', 'dracula']
suppress is a word found in the books: ['frankenstein', 'mobydick', 'pride', 'alice', 'dracula', 'jane']
exemplary is a word found in the books: ['mobydick', 'littlewomen', 'scarletletter', 'crimepunish', 'taleoftwocities']
innate is a word found in the books: ['mobydick', 'scarletletter', 'crimepunish', 'jane']
surpass is a word found in the books: ['mobydick', 'pride', 'littlewomen', 'jane']
susceptible is a word found in the books: ['frankenstein', 'mobydick', 'jane']
suspense is a word found in the books: ['frankenstein', 'mobydick', 'pride', 'jekyllhyde', 'littlewomen', 'crimepunish', 'dracula', 'jane', 'taleoftwocities']
exploit is a word found in the books: ['frankenstein', 'mobydick', 'littlewomen', 'crimepunish']
facilitate is a word found in the books: ['mobydick', 'crimepunish', 'taleoftwocities']
inscrutable is a word found in the books: ['mobydick', 'jekyllhyde', 'scarletletter', 'jane', 'taleoftwocities']
premise is a word found in the books: ['littlewomen', 'dracula', 'jane']
intangible is a word found in the books: ['mobydick', 'scarletletter', 'taleoftwocities']
integrity is a word found in the books: ['frankenstein', 'mobydick', 'pride', 'littlewomen', 'scarletletter', 'jane', 'taleoftwocities']
sustain is a word found in the books: ['frankenstein', 'mobydick', 'littlewomen', 'scarletletter', 'jane', 'taleoftwocities']
symmetry is a word found in the books: ['frankenstein', 'mobydick', 'pride']
taciturn is a word found in the books: ['pride', 'jane', 'taleoftwocities']
prevail is a word found in the books: ['frankenstein', 'mobydick', 'pride', 'jekyllhyde', 'littlewomen', 'scarletletter', 'dracula', 'taleoftwocities']
prey is a word found in the books: ['frankenstein', 'mobydick', 'pride', 'crimepunish', 'dracula', 'jane', 'taleoftwocities']
fastidious is a word found in the books: ['frankenstein', 'mobydick', 'pride', 'littlewomen', 'scarletletter', 'jane']
profound is a word found in the books: ['frankenstein', 'mobydick', 'jekyllhyde', 'littlewomen', 'scarletletter', 'crimepunish', 'dracula', 'jane', 'taleoftwocities']
tedious is a word found in the books: ['frankenstein', 'mobydick', 'pride', 'littlewomen', 'scarletletter', 'crimepunish', 'jane', 'taleoftwocities']
temper is a word found in the books: ['frankenstein', 'mobydick', 'pride', 'jekyllhyde', 'alice', 'littlewomen', 'scarletletter', 'crimepunish', 'dracula', 'jane', 'taleoftwocities']
judicious is a word found in the books: ['mobydick', 'jane', 'taleoftwocities']
temperament is a word found in the books: ['scarletletter', 'crimepunish', 'dracula', 'jane', 'taleoftwocities']
languid is a word found in the books: ['frankenstein', 'mobydick', 'alice', 'littlewomen', 'scarletletter', 'crimepunish', 'dracula', 'jane']
termination is a word found in the books: ['frankenstein', 'mobydick', 'pride', 'jekyllhyde', 'jane']
prominent is a word found in the books: ['mobydick', 'littlewomen', 'scarletletter', 'crimepunish', 'jane', 'taleoftwocities']
thwart is a word found in the books: ['mobydick', 'littlewomen', 'dracula']
lethargic is a word found in the books: ['dracula', 'jane', 'taleoftwocities']
promote is a word found in the books: ['pride', 'scarletletter', 'crimepunish']
frail is a word found in the books: ['frankenstein', 'mobydick', 'littlewomen', 'crimepunish', 'jane']
prophetic is a word found in the books: ['frankenstein', 'mobydick', 'littlewomen', 'scarletletter', 'taleoftwocities']
frivolous is a word found in the books: ['pride', 'littlewomen', 'crimepunish', 'jane']
malice is a word found in the books: ['frankenstein', 'mobydick', 'pride', 'scarletletter', 'crimepunish', 'dracula', 'jane', 'taleoftwocities']
prosperity is a word found in the books: ['frankenstein', 'pride', 'scarletletter', 'dracula', 'jane', 'taleoftwocities']
transparent is a word found in the books: ['frankenstein', 'mobydick', 'littlewomen', 'scarletletter', 'crimepunish', 'dracula', 'jane', 'taleoftwocities']
meek is a word found in the books: ['littlewomen', 'crimepunish', 'jane']
trepidation is a word found in the books: ['mobydick', 'pride', 'crimepunish', 'jane', 'taleoftwocities']
prudent is a word found in the books: ['frankenstein', 'mobydick', 'pride', 'littlewomen', 'crimepunish']
ramble is a word found in the books: ['frankenstein', 'pride', 'littlewomen', 'scarletletter', 'jane']
random is a word found in the books: ['mobydick', 'jekyllhyde', 'crimepunish', 'taleoftwocities']
gratify is a word found in the books: ['frankenstein', 'pride', 'littlewomen', 'crimepunish', 'jane']
mock is a word found in the books: ['frankenstein', 'mobydick', 'alice', 'littlewomen', 'scarletletter', 'crimepunish', 'dracula', 'taleoftwocities']
recluse is a word found in the books: ['mobydick', 'jekyllhyde', 'scarletletter']
gregarious is a word found in the books: ['mobydick', 'jane', 'taleoftwocities']
volatile is a word found in the books: ['mobydick', 'jekyllhyde', 'scarletletter', 'jane']
relinquish is a word found in the books: ['frankenstein', 'mobydick', 'pride', 'littlewomen', 'scarletletter', 'jane', 'taleoftwocities']
hindrance is a word found in the books: ['frankenstein', 'crimepunish', 'dracula', 'jane']
renown is a word found in the books: ['mobydick', 'scarletletter', 'jane']
wary is a word found in the books: ['mobydick', 'littlewomen', 'scarletletter', 'dracula', 'taleoftwocities']
